WWWWWWWWWWWWWWWW
WP             W
WDD BD      D  W
W     DD       W
W     DD       W
W   E          W
W          B   W
W              W
W   D          W
W              W
W    D         W
W      D       W
W     DD       W
W              W
W              W
WWWWWWWWWWWWWWWW