xxxxxxxxxxxxxxxx
xP             x
xWW WW      E  x
x     WW       x
x     WW       x
x   E          x
x          W   x
xxxxxxxxxxxxxxxx