xxxxxxxxxxxxxxxx
xP             x
xDD DD      D  x
x     DD       x
x     DD       x
x   E          x
x          D   x
xxxxxxxxxxxxxxxx